Zip Code,Population,Male,Female,Median age (years),Male Median age (years),Female Median age (years)
89010,31,18,13,26.5,24.5,26.5
89019,69,39,30,38.3,38.5,38
89060,30,15,15,44,38.5,48.5
89061,51,23,28,47.5,40.5,50
89439,80,41,39,57.5,57.5,57.5
90001,57110,28468,28642,26.6,26.1,27.1
90002,51223,24876,26347,25.5,24.6,26.5
90003,66266,32631,33635,26.3,25.5,27.1
90004,62180,31302,30878,34.8,33.7,36
90005,37681,19299,18382,33.9,32.6,35.6
90006,59185,30254,28931,32.4,31.6,33.3
90007,40920,20915,20005,24,23.9,24.2
90008,32327,14477,17850,39.7,36.5,42.1
90010,3800,1874,1926,37.8,37.5,38.2
90011,103892,52794,51098,26.2,26,26.5
90012,31103,19493,11610,36.3,35.2,38.8
90013,11772,7629,4143,44.6,45.7,41.5
90014,7005,4471,2534,44.8,45.6,41.7
90015,18986,9833,9153,31.3,31.7,30.8
90016,47596,22778,24818,33.9,31.8,35.8
90017,23768,12818,10950,29.4,29.6,29.2
90018,49310,23770,25540,33.2,31.2,35.3
90019,64458,31442,33016,35.8,34.4,37.3
90020,38967,19381,19586,34.6,34,35.2
90021,3951,2790,1161,44.3,46,38.3
90022,67179,33216,33963,29.8,28.6,31
90023,45903,23037,22866,28.4,27.7,29.1
90024,47452,22248,25204,23.6,24.1,23.1
90025,42147,20859,21288,34.7,34.2,35.2
90026,67869,34515,33354,34,33.6,34.4
90027,45151,22362,22789,38.3,38.1,38.6
90028,28714,16056,12658,34,34,33.9
90029,38617,19575,19042,34.6,33.3,36.2
90031,39316,19546,19770,33.5,32.3,34.6
90032,45786,22564,23222,32.4,31.3,33.5
90033,48852,24425,24427,29.2,28,30.5
90034,57964,28828,29136,32.8,32.3,33.3
90035,28418,13326,15092,37.5,36.7,38.3
90036,36865,17914,18951,33.9,34.6,33.3
90037,62276,31187,31089,28.8,28,29.7
90038,28917,15383,13534,33.1,32.6,33.8
90039,28514,14383,14131,38.8,38.5,39.1
90040,12520,6129,6391,31.2,29.7,32.7
90041,27425,13212,14213,39,37.3,40.4
90042,62430,30836,31594,33.6,32.7,34.4
90043,44789,20561,24228,38.7,35.6,40.8
90044,89779,43128,46651,28.6,27.2,29.9
90045,39480,18958,20522,35.6,34.9,36.3
90046,48581,25854,22727,38.5,39.2,37.5
90047,48606,22129,26477,36.2,32.7,38.8
90048,21397,10132,11265,39.2,39.3,39.1
90049,35482,16359,19123,41.3,41.4,41.1
90056,7827,3436,4391,48.4,46.7,49.5
90057,44998,24300,20698,31.2,30.4,32.4
90058,3223,1555,1668,26,23.7,28.2
90059,40952,19623,21329,25.7,24.3,27
90061,26872,13049,13823,28.4,27,29.8
90062,32821,15720,17101,31.8,29.9,33.7
90063,55758,27843,27915,29,28.3,29.8
90064,25403,12297,13106,40,38.8,41.3
90065,45527,22873,22654,36.1,35.3,36.8
90066,55277,27714,27563,37.3,36.3,38.4
90067,2424,1074,1350,65.3,64.7,65.9
90068,22286,12018,10268,39.4,40.2,38.3
90069,20483,12153,8330,41.5,42.3,40
90071,15,13,2,45.5,45.5,36.5
90073,539,506,33,56.9,56.9,56.5
90077,9377,4594,4783,47.9,48,47.7
90079,0,0,0,0,0,0
90089,3217,1436,1781,19.3,19.3,19.2
90090,0,0,0,0,0,0
90094,5464,2559,2905,33.7,34,33.3
90095,3,2,1,52.5,38.5,52.5
90201,101279,50658,50621,27.8,27.1,28.4
90210,21741,10292,11449,47.5,47.9,47.1
90211,8434,3849,4585,40.6,40,41.1
90212,11555,5211,6344,41.2,40.5,41.8
90220,49328,23773,25555,29.8,28.1,31.6
90221,53704,26346,27358,26.7,26.1,27.3
90222,31869,15375,16494,27.3,26.3,28.2
90230,31766,14932,16834,39.1,36.7,41.2
90232,15149,7333,7816,38.6,36.9,40
90240,25876,12501,13375,35.5,34,36.9
90241,42399,20466,21933,33.9,32.4,35.3
90242,43497,21207,22290,31.6,30.5,32.8
90245,16654,8304,8350,39.2,38.4,39.8
90247,47487,23217,24270,35.5,34.1,36.8
90248,9947,4823,5124,41.2,39.8,42.5
90249,26669,12897,13772,37.2,35.9,38.3
90250,93193,45113,48080,31.9,30.9,32.8
90254,19506,10273,9233,37,37.3,36.6
90255,75066,37525,37541,29.1,28.2,29.9
90260,34924,17509,17415,32.7,31.6,33.7
90262,69745,33919,35826,27.8,27,28.6
90263,1612,665,947,19.7,19.7,19.6
90265,18116,9159,8957,46.5,46.3,46.7
90266,35135,17605,17530,40.9,40.7,41
90270,27372,13992,13380,27.9,27.4,28.5
90272,22986,10952,12034,47.3,46.8,47.7
90274,25209,12199,13010,49.4,49.4,49.4
90275,41804,20283,21521,47.8,47.1,48.4
90277,35293,17521,17772,42,41.9,42.1
90278,40071,19848,20223,38.2,37.6,38.8
90280,94396,46321,48075,29.4,28.5,30.2
90290,6368,3180,3188,45,45.6,44.5
90291,28341,14757,13584,37.6,37.8,37.4
90292,21576,10729,10847,41.2,41.4,41
90293,12132,5890,6242,40.4,39.8,40.9
90301,36568,17633,18935,32.6,31.2,33.9
90302,29415,13803,15612,32.8,31.3,34.1
90303,26176,12733,13443,30.4,28.9,31.9
90304,28210,14503,13707,28.1,27.9,28.3
90305,14853,6552,8301,43.3,40.2,45.4
90401,6722,3524,3198,37.8,38.2,37.3
90402,12250,5809,6441,47,46.7,47.2
90403,24525,11426,13099,40.8,40.4,41.1
90404,21360,10292,11068,37.4,35.8,39
90405,27186,13364,13822,40.8,40.3,41.4
90501,43180,21483,21697,35,33.9,36.1
90502,18010,8811,9199,40.2,38.4,42
90503,44383,21481,22902,40.8,39.8,41.7
90504,32102,15886,16216,40.3,38.9,41.7
90505,36678,17684,18994,43,41.9,44
90506,0,0,0,0,0,0
90601,31974,15312,16662,36.6,35.7,37.5
90602,25777,12720,13057,30.9,30,32
90603,20063,9694,10369,39.4,38.1,40.7
90604,39407,19270,20137,34.1,32.9,35.3
90605,40331,20033,20298,32.6,31.4,33.8
90606,32396,15936,16460,33.5,32.1,34.8
90620,45113,22241,22872,37.9,36,39.6
90621,35153,17377,17776,32.1,31.2,33.2
90623,15554,7516,8038,41.2,39.8,42.5
90630,47993,23204,24789,40,38.3,41.3
90631,67619,33320,34299,34.8,33.5,36.2
90638,49012,23520,25492,37.9,36.5,39.1
90640,62549,30189,32360,34.7,32.9,36.5
90650,105549,52364,53185,32.5,31,34.1
90660,62928,30738,32190,34,32.6,35.3
90670,14866,7163,7703,36.2,34,38.2
90680,29945,14811,15134,33.5,32,34.8
90701,16591,8227,8364,38.2,36.9,39.5
90703,49399,23785,25614,43.9,42.2,45.2
90704,4090,2101,1989,37.2,36.4,37.9
90706,76615,37203,39412,31.9,30.8,33.1
90710,25457,12291,13166,36.7,35.1,38
90712,31499,15277,16222,38.4,36.9,39.6
90713,27925,13574,14351,39,37.8,40
90715,20388,9935,10453,33.9,32.5,35.3
90716,14184,7078,7106,28.3,26.9,30
90717,21318,10317,11001,39.5,37.9,40.7
90720,21751,10423,11328,41.7,40.3,42.9
90723,54099,26315,27784,28.6,27.7,29.4
90731,59662,29951,29711,35.6,35.1,36.2
90732,21115,9843,11272,45,42.8,46.8
90740,23729,10423,13306,57.5,53.7,60.6
90742,831,454,377,45.8,44.8,47.7
90743,456,238,218,45.2,45.1,45.3
90744,53815,27298,26517,28.7,28.2,29.3
90745,57251,27754,29497,37.1,35.4,38.6
90746,25990,11944,14046,40.7,38.5,42.4
90747,0,0,0,0,0,0
90755,11074,5462,5612,36.1,35.8,36.4
90802,39347,20387,18960,34.7,35.7,33.6
90803,32031,15609,16422,42.7,42.9,42.6
90804,40311,19686,20625,29.8,29.7,30
90805,93524,45229,48295,29,27.9,30.1
90806,42399,20717,21682,30.3,29.1,31.5
90807,31481,15153,16328,39.7,38.7,40.7
90808,38232,18408,19824,41.6,40.5,42.7
90810,36735,18067,18668,31.8,30.6,32.9
90813,58911,29425,29486,27.3,27,27.5
90814,19131,9356,9775,37.2,37,37.3
90815,39733,19124,20609,37.9,36.8,38.8
90822,117,109,8,63.9,64.8,47
90831,0,0,0,0,0,0
91001,36126,17421,18705,41.6,40.1,43.2
91006,31715,15283,16432,42.7,41.7,43.6
91007,34095,16039,18056,43.8,42.3,45.1
91008,1391,614,777,54.6,51.4,58
91010,26074,12461,13613,38.1,36,40
91011,20280,9863,10417,45.9,45.5,46.2
91016,40598,19434,21164,37.9,35.9,39.6
91020,8415,3966,4449,40.2,38.3,41.6
91024,10917,5165,5752,46.6,45.4,47.6
91030,25616,12160,13456,40.1,39.2,40.8
91040,20372,10120,10252,43.3,42.4,44
91042,27585,13734,13851,40.7,39.7,41.8
91046,156,51,105,74,65.5,78.2
91101,20460,9926,10534,33.7,33.2,34.3
91103,27480,13481,13999,35,33.4,36.8
91104,36751,17874,18877,38.2,36.9,39.6
91105,11254,5432,5822,49,47.6,50.5
91106,24229,11993,12236,34.6,33.2,36.3
91107,32940,15940,17000,41.2,39.9,42.6
91108,13361,6410,6951,45.4,44.7,46
91201,22781,11123,11658,40.4,39,41.7
91202,22830,10805,12025,41.7,40.1,43
91203,13220,6279,6941,38.9,37.6,40.4
91204,16032,7699,8333,38.1,36.6,39.5
91205,37810,18084,19726,39.1,36.7,41.1
91206,33065,15544,17521,42.6,41,43.9
91207,10506,4924,5582,45.5,45.2,45.8
91208,16245,7756,8489,43.6,43.1,44
91210,328,162,166,33.9,33.9,34
91214,30356,14642,15714,42.5,41.5,43.3
91301,25488,12511,12977,42.7,41.8,43.5
91302,25709,12487,13222,42.4,41.8,42.9
91303,26855,13907,12948,31.1,30.4,32.1
91304,50231,24827,25404,35.9,34.6,37.4
91306,45061,22679,22382,35.4,34,36.7
91307,24474,11939,12535,43.4,42.1,44.5
91311,36557,17838,18719,42.7,41.2,44.1
91316,26898,12717,14181,42.1,40.7,43.6
91320,44274,21952,22322,39.9,39.1,40.7
91321,34882,17402,17480,33.3,31.2,35.5
91324,27669,13545,14124,36.5,34.6,38.3
91325,32417,15819,16598,35.4,33.7,37.2
91326,33708,16394,17314,42.7,41.7,43.6
91330,2702,1103,1599,19.6,19.7,19.5
91331,103689,52358,51331,29.5,28.9,30.2
91335,74363,36596,37767,35.5,33.9,37.1
91340,34188,17130,17058,30.1,29.5,30.8
91342,91725,45786,45939,31.9,30.6,33.1
91343,60254,30145,30109,32.3,31.3,33.4
91344,51747,25212,26535,41,39.8,42.2
91345,18496,9110,9386,35.7,33.5,38.1
91350,33348,16270,17078,36.4,35.4,37.4
91351,32362,16086,16276,33.9,32.5,35.2
91352,47807,23980,23827,32.1,31.3,33
91354,28722,14046,14676,36.4,35.5,37.1
91355,32605,15773,16832,38.8,37.4,39.9
91356,29458,14216,15242,41.7,40.4,43
91360,42402,20755,21647,41.5,39.7,43.5
91361,20438,9854,10584,47.6,46.4,48.7
91362,36045,17562,18483,42.6,41.5,43.7
91364,25851,12739,13112,44,43.1,45
91367,39499,19171,20328,41,39.7,42.3
91371,1,0,1,73.5,0,73.5
91377,13811,6641,7170,41.7,40.3,42.8
91381,20158,9852,10306,36,35.2,36.6
91384,29855,18503,11352,32.5,30.9,36.1
91387,40328,20106,20222,33,32,34
91390,19786,9911,9875,40.1,40.1,40.1
91401,39285,19613,19672,36,34.7,37.3
91402,69817,35095,34722,30.1,29,31.3
91403,23484,11277,12207,39.4,38.6,40.2
91405,51145,25498,25647,32.6,31.5,33.7
91406,51558,25956,25602,33.6,32.6,34.6
91411,24628,12495,12133,33.8,32.8,34.9
91423,30991,14789,16202,39.2,38.5,39.8
91436,14372,6890,7482,46.5,46.2,46.8
91501,20849,10040,10809,38.3,36.9,39.4
91502,11371,5402,5969,36.4,34.3,38.5
91504,24939,12006,12933,38.6,37.4,39.8
91505,30778,15121,15657,38.9,38.2,39.6
91506,18904,9115,9789,40.9,39.8,42
91601,37180,18932,18248,32.9,32.9,33
91602,17473,8722,8751,38,38.1,37.8
91604,29034,14271,14763,40.2,40.3,40.2
91605,56343,28417,27926,31.9,30.9,32.9
91606,44958,22376,22582,34.3,33.1,35.6
91607,27927,13635,14292,38.2,37.3,39
91608,0,0,0,0,0,0
91701,38976,18966,20010,39.6,37.9,40.9
91702,59705,29486,30219,29.4,28.8,30.2
91706,76571,37969,38602,30.5,29.4,31.8
91708,3369,685,2684,36,30.6,36.9
91709,74796,36954,37842,36.6,35.6,37.5
91710,80358,42283,38075,33,32.5,33.7
91711,35705,16777,18928,38.6,36.7,40.1
91722,34409,16859,17550,34,32.6,35.5
91723,18275,8783,9492,35,32.9,36.7
91724,26184,12780,13404,37.9,35.8,39.7
91730,66925,33393,33532,32,30.9,33.2
91731,29591,14888,14703,32.9,31.4,34.6
91732,61386,30755,30631,31.4,30.3,32.6
91733,43896,22191,21705,30.5,29.7,31.4
91737,24740,12089,12651,38.5,36.9,39.7
91739,34794,17254,17540,33,32.3,33.8
91740,25356,12269,13087,38.5,36.6,40.3
91741,25824,12498,13326,41.8,40.5,43
91744,85040,42564,42476,30.9,29.9,32.1
91745,54013,26287,27726,40.1,38.4,41.7
91746,30485,15116,15369,32.4,31.3,33.4
91748,45406,22368,23038,39.8,38,41.3
91750,33249,15881,17368,42.6,40.4,44.5
91752,30047,14981,15066,32.2,31.7,32.7
91754,32742,15620,17122,42.9,41.1,44.6
91755,27496,13271,14225,43.4,41.6,45.1
91759,476,239,237,47.2,45.6,47.6
91761,56913,28360,28553,30.6,29.9,31.4
91762,55857,27686,28171,30.4,29.3,31.6
91763,36375,18099,18276,30.8,29.3,32.3
91764,54086,27027,27059,28.7,28,29.5
91765,46457,22702,23755,40.8,39.3,42.1
91766,71599,36111,35488,28.7,27.8,29.8
91767,48068,23685,24383,31.2,30,32.4
91768,34537,17509,17028,27.3,26.4,28.4
91770,62097,30521,31576,38.3,36.9,39.7
91773,33119,15737,17382,42.5,40.7,44.1
91775,23988,11448,12540,41.4,40,42.7
91776,38475,18751,19724,39,37.5,40.4
91780,34332,16438,17894,41.1,39.7,42.3
91784,25938,12729,13209,44.5,44,45.1
91786,51165,24516,26649,33,31.5,34.5
91789,43079,20988,22091,42.8,41.2,44.2
91790,44907,21721,23186,35.2,33.5,36.7
91791,32414,15512,16902,38,35.7,40
91792,30854,14950,15904,35.3,33.3,37.4
91801,52735,24833,27902,39.1,37.1,40.8
91803,30322,14486,15836,39.6,37.9,41.2
91901,17403,8750,8653,41.9,40.6,43.2
91902,17653,8603,9050,43.2,41.9,44.3
91905,1700,965,735,46,44.2,47.6
91906,3627,1959,1668,37.2,35.8,39.1
91910,75802,36862,38940,35.6,33.4,37.5
91911,82999,39938,43061,33.5,31.4,35.2
91913,40971,19793,21178,32,30.9,33
91914,15448,7521,7927,34.2,33.4,34.7
91915,24659,12044,12615,31.8,30.9,32.5
91916,1622,828,794,48.8,48.8,48.8
91917,992,513,479,39.8,39.6,40
91931,592,305,287,43.7,43.8,43.6
91932,25718,12874,12844,31.5,30.4,32.8
91934,737,378,359,45.8,47.3,44.9
91935,8624,4392,4232,46.7,46.7,46.8
91941,31779,15341,16438,40.7,39.4,41.9
91942,38069,18064,20005,37.5,35.6,39.7
91945,25460,12426,13034,35,33.9,36
91948,78,36,42,60.8,65.5,59.5
91950,60322,31009,29313,30.2,27.8,33.3
91962,1646,827,819,48.6,49,48.3
91963,1118,576,542,37.9,37.8,38
91977,58368,28506,29862,33.5,32,34.9
91978,8896,4347,4549,36.8,34.6,39
91980,165,79,86,35.5,36.5,34.5
92003,4746,2335,2411,44.7,44.9,44.5
92004,3881,1943,1938,55.3,56.1,54.8
92007,10429,5239,5190,39.9,39,40.8
92008,27649,14098,13551,39.3,37.2,41.5
92009,40747,19672,21075,40.2,39.6,40.8
92010,14382,6950,7432,39.8,38.9,40.5
92011,22405,10700,11705,42.4,41.3,43.4
92014,13154,6509,6645,49.1,48.6,49.5
92019,42598,20799,21799,39.2,37.6,40.6
92020,57767,28375,29392,34.7,33.3,36.1
92021,65068,31821,33247,35.3,34,36.6
92024,49121,24214,24907,42,40.7,43.3
92025,49978,25149,24829,31.1,30.4,32
92026,48922,24017,24905,37.4,35.9,38.8
92027,53881,26927,26954,32.4,31.5,33.5
92028,46239,23098,23141,40,38.6,41.2
92029,19021,9292,9729,43.4,42.2,44.6
92036,3440,1755,1685,52.4,52,52.7
92037,46781,22678,24103,34.7,33,36.4
92040,41281,20565,20716,38.5,37.1,39.7
92054,40375,20529,19846,32.6,32.1,33.2
92055,15655,14267,1388,21.4,21.4,21
92056,51835,25146,26689,38.4,35.9,40.6
92057,54096,26405,27691,34.7,33,36.2
92058,42436,22025,20411,24.6,23.8,25.6
92059,1618,796,822,30.9,29.5,32.4
92060,218,119,99,55.2,54.8,55.8
92061,2499,1290,1209,42,39.6,43.9
92064,47904,23604,24300,41.3,39.8,42.7
92065,35414,17837,17577,39.7,38.9,40.4
92066,378,195,183,51.4,52.9,49.1
92067,9535,4691,4844,50.2,50.5,49.8
92069,46369,23166,23203,31.5,30.5,32.6
92070,1245,626,619,44.2,43.7,44.8
92071,53422,25826,27596,37.2,35.7,38.6
92075,12056,5953,6103,43.3,42,44.4
92078,42906,20311,22595,36.6,35.5,37.6
92081,27404,13663,13741,35.3,33.6,37.4
92082,19037,9626,9411,41.4,41,41.8
92083,36975,18844,18131,29.1,28.7,29.7
92084,47654,23840,23814,33.9,32.8,35
92086,1573,737,836,54.7,55.8,53.1
92091,1048,476,572,59,60.2,58.6
92101,37095,22255,14840,37.3,38.3,35.6
92102,43267,21915,21352,30.5,30.4,30.6
92103,31066,16155,14911,40.5,41.5,39.2
92104,44414,22811,21603,34.3,34.8,33.7
92105,69813,34661,35152,28.8,28.2,29.5
92106,19330,9871,9459,39.2,37.5,41
92107,28651,14778,13873,33.9,34.1,33.6
92108,18858,9446,9412,30.6,31.3,29.9
92109,45787,24648,21139,30.6,31,30
92110,25341,12715,12626,33.6,34.1,33.1
92111,45096,22275,22821,35.6,34.2,37.1
92113,56066,30009,26057,25.2,24.3,26.9
92114,65433,32091,33342,33.7,31.9,35.6
92115,58560,29075,29485,28,27.8,28.3
92116,31680,15980,15700,36,36.6,35.4
92117,51332,25877,25455,38.7,36.9,40.4
92118,23575,13532,10043,32.7,28,41.3
92119,23057,11041,12016,43,40.9,45.1
92120,26317,12686,13631,42.9,41.3,44.4
92121,4179,2182,1997,30.2,29.5,31.1
92122,43728,21619,22109,30.7,30.2,31.2
92123,26823,13237,13586,32.6,31.5,33.7
92124,30443,14945,15498,30.4,29.6,31.2
92126,73343,38728,34615,33.3,31.1,35.9
92127,39337,19303,20034,35.2,34.3,35.9
92128,47490,22379,25111,42.3,40.5,44.1
92129,51536,25509,26027,38,36.8,39.1
92130,48940,23932,25008,37.6,37.2,38
92131,32787,16089,16698,38.7,38.4,39.1
92132,0,0,0,0,0,0
92134,198,161,37,23.1,23.3,22.5
92135,571,502,69,22,22.2,20.9
92139,35125,16905,18220,32.8,31,34.6
92140,3435,3407,28,20,20,21.7
92145,1449,713,736,31.4,31.2,31.7
92147,559,455,104,22.4,22.9,21
92154,79708,41254,38454,32.9,31.8,34.2
92155,550,508,42,23.5,23.7,21.8
92173,29429,13906,15523,29.2,26.4,31.8
92201,61827,30567,31260,30.8,29.6,32
92203,25605,12597,13008,36.5,35.8,37.3
92210,4677,2132,2545,67.1,68.2,66.4
92211,24294,11257,13037,63.8,64,63.7
92220,31638,15295,16343,42.2,38.7,45.6
92222,45,26,19,36.3,35,36.8
92223,43605,21206,22399,34.5,33.7,35.3
92225,24310,16065,8245,37.9,39.2,33.4
92227,26234,12808,13426,30.5,29.3,31.8
92230,2550,1279,1271,31.4,30.3,32.9
92231,39073,18512,20561,31.9,29.3,34.1
92233,8099,6116,1983,33,33.2,30.7
92234,51151,26308,24843,36,36.1,35.9
92236,41083,20488,20595,24.6,24,25.1
92239,223,117,106,47.7,47.3,48.5
92240,34722,17428,17294,31.7,30.9,32.4
92241,8803,4457,4346,51.7,50.1,53.6
92242,1539,779,760,57.3,57.3,57.4
92243,48030,23812,24218,32.1,30.2,34.2
92249,7334,3512,3822,27.6,26.4,28.3
92250,8285,4078,4207,34.3,33.7,34.8
92251,21583,12891,8692,31.6,31.7,31.3
92252,9647,4836,4811,40.7,39.4,42.1
92253,37262,18000,19262,45.6,44.6,46.5
92254,12768,6702,6066,23.7,23.7,23.7
92256,3588,1846,1742,47.3,46.8,47.9
92257,2326,1183,1143,53.5,52.8,54.2
92258,861,471,390,31,30.7,31.5
92259,390,213,177,55.7,55.8,55.6
92260,31753,14920,16833,52.3,50,54.3
92262,26179,14506,11673,47.8,48.3,46.9
92264,19383,11143,8240,56.3,55.4,58
92266,234,134,100,54.8,55.8,52.5
92267,126,63,63,60,61.8,57.5
92268,574,294,280,56.4,57,55.5
92270,17220,8510,8710,62.3,61.7,62.7
92273,1823,887,936,28.4,26.6,30.2
92274,19801,10482,9319,25.5,25.4,25.8
92275,1506,749,757,38.5,38.4,38.5
92276,7585,3799,3786,42.7,39.9,45.1
92277,23911,12070,11841,25.9,25.8,26.1
92278,3846,3494,352,21.6,21.6,21.3
92280,14,2,12,64,28,65.5
92281,2432,1138,1294,29.7,29,30.4
92282,1239,664,575,41.2,41.4,40.9
92283,3158,1531,1627,34,34.8,33.6
92284,25095,12324,12771,41.2,39.9,42.7
92285,2632,1388,1244,51.3,51.8,50.8
92301,32725,16857,15868,25.6,25.3,26
92304,17,13,4,46.5,46.5,47.5
92305,535,264,271,48.2,48.5,47.9
92307,37630,18650,18980,37.2,35.3,39.1
92308,39837,19416,20421,38.1,35.9,40
92309,763,410,353,26.5,25.2,27.8
92310,8845,5034,3811,23.9,24.2,23.3
92311,31894,16007,15887,32.2,31,33.5
92313,12025,5793,6232,36.1,34.3,37.9
92314,10162,5138,5024,43.2,42.1,44.4
92315,5094,2615,2479,46.3,44.3,48.2
92316,30830,15538,15292,28.3,27.4,29
92320,7788,3734,4054,48.9,46.9,50.9
92321,1522,803,719,37.5,35.7,40.2
92322,1257,636,621,45.2,45.2,45.1
92324,56505,27716,28789,28.7,28,29.4
92325,9391,4772,4619,43,42.8,43.3
92327,632,336,296,44.9,45,44.9
92328,445,261,184,47.9,48.9,44.6
92332,65,47,18,51.5,47.5,53.5
92333,472,235,237,54.6,55,53.5
92335,95397,47699,47698,26.9,26.2,27.6
92336,88419,43786,44633,30.1,29.1,31
92337,37849,18966,18883,28.8,27.8,29.6
92338,12,5,7,49,52.5,28.5
92339,885,445,440,45,45.1,44.8
92341,410,225,185,48.9,48.9,48.9
92342,6379,3189,3190,45.7,45.1,46.3
92344,20769,10329,10440,30.9,30.3,31.4
92345,78715,39118,39597,31.2,30,32.4
92346,54923,26943,27980,34.5,33.6,35.4
92347,1692,857,835,38.9,38.9,38.9
92352,8004,4036,3968,45.6,45.6,45.6
92354,21559,10100,11459,34.1,32.4,35.7
92356,6455,3356,3099,43.5,43.4,43.6
92358,707,366,341,52.1,51.6,52.9
92359,8103,4017,4086,34.5,33.3,35.6
92363,5321,2683,2638,40,37.3,42
92364,90,47,43,43.3,43.8,38.5
92365,2637,1339,1298,45.2,45.2,45.2
92368,1113,592,521,33.1,34.6,32.3
92371,16763,8565,8198,37.9,37.2,38.5
92372,6220,3136,3084,41.8,41.5,42
92373,33423,15762,17661,39.7,38.5,40.7
92374,40267,19353,20914,32.7,30.9,34.4
92376,81516,39551,41965,27.6,26.5,28.7
92377,19989,9894,10095,32.6,31.4,33.8
92378,183,89,94,38.5,41.3,36.5
92382,5268,2710,2558,41.9,41.8,42
92384,36,18,18,46,46,46
92385,313,150,163,50.1,51,49.1
92386,2270,1163,1107,41.7,40.3,43.2
92389,156,89,67,56.7,56.8,55.9
92391,2534,1317,1217,35.8,33.8,37.4
92392,54858,26839,28019,29.4,28.4,30.5
92394,33237,18149,15088,29.8,30.7,28.4
92395,42400,20290,22110,31.7,30.2,33.3
92397,4894,2522,2372,44.1,44,44.2
92398,1379,707,672,40.3,39.5,41.1
92399,52606,25954,26652,38.1,36.4,39.5
92401,1932,953,979,27,25.9,28
92404,58271,28141,30130,29.1,27.7,30.4
92405,28873,14249,14624,28.5,27.6,29.5
92407,56689,28105,28584,27.5,27,28
92408,15271,8413,6858,30.2,30.4,29.9
92410,49410,24251,25159,25.5,24.6,26.2
92411,26214,12803,13411,26.7,25.4,27.7
92501,20970,10789,10181,31.4,31.1,31.8
92503,84519,42058,42461,30.8,29.7,32.1
92504,53778,26232,27546,32.4,30.7,34.2
92505,47672,23563,24109,29.8,29.1,30.5
92506,44001,21413,22588,40.4,38.5,42.1
92507,58002,28739,29263,24.2,24.1,24.3
92508,35000,17320,17680,33,31.5,34.2
92509,75196,37947,37249,29.9,29.2,30.6
92518,1162,599,563,62.9,57,76.5
92530,50216,25354,24862,30.2,29.7,30.9
92532,18644,9289,9355,31.1,30.7,31.4
92536,3810,1964,1846,48.4,48.6,48.3
92539,4734,2393,2341,46.1,46.4,45.7
92543,33555,15679,17876,37,34.4,39.2
92544,44734,21850,22884,37.1,35.8,38.2
92545,39457,18762,20695,41.9,39.2,44.9
92548,6643,3363,3280,36.4,33.9,38.7
92549,3926,1955,1971,49.9,49.8,50.1
92551,30815,14916,15899,27.3,26.3,28.2
92553,73722,36130,37592,26.8,25.7,28
92555,39076,19025,20051,30.6,29.3,31.9
92557,50320,24491,25829,30.8,29.3,32.3
92561,1661,866,795,53.5,54.6,52.3
92562,62079,30267,31812,35.7,33.7,37.3
92563,53892,26874,27018,32,30.8,33.2
92567,9459,4730,4729,33.2,33,33.4
92570,53697,27501,26196,29,28.6,29.5
92571,52516,25943,26573,25.8,24.8,26.7
92582,15649,7666,7983,28.5,27.7,29.3
92583,30236,14702,15534,32.3,30.5,33.9
92584,43400,21401,21999,32.6,31.6,33.5
92585,17797,8845,8952,32.6,31.2,33.7
92586,19815,8751,11064,60.6,57.1,62.7
92587,16675,8356,8319,38.1,37.3,38.7
92590,3660,1804,1856,42.2,42,42.3
92591,38272,18675,19597,33.5,31.9,35
92592,72492,35736,36756,34.6,33.8,35.3
92595,29851,14712,15139,34.9,33.8,35.9
92596,23172,11520,11652,31.1,30.6,31.7
92602,22871,11143,11728,33.9,34,33.8
92603,20184,10024,10160,39.6,39.1,40
92604,26853,12997,13856,40.1,37.4,42.1
92606,21495,10466,11029,34.8,33.8,35.6
92610,11248,5623,5625,35.7,35.2,36.1
92612,27522,13425,14097,30.6,29.6,31.8
92614,24748,11975,12773,35,33.3,36.6
92617,14044,6721,7323,20.6,21.1,20.3
92618,16366,8252,8114,33.8,33.2,34.3
92620,38486,18533,19953,37,36,37.8
92624,7248,3652,3596,43.1,41.7,44.6
92625,12478,5817,6661,50.2,50.1,50.2
92626,49341,24786,24555,34.3,33.7,35.1
92627,61510,31607,29903,33.1,32.7,33.6
92629,25756,12693,13063,45.4,44,46.5
92630,59182,29398,29784,37.6,35.9,39.3
92637,16012,5716,10296,76.8,76.1,77.1
92646,55224,27076,28148,43,41.7,44.2
92647,57245,28566,28679,35.5,34.5,36.6
92648,45317,22719,22598,39.9,39.1,40.7
92649,32463,16037,16426,43.8,43,44.5
92651,23881,11977,11904,48.3,48.5,48.2
92653,29291,14371,14920,40.5,38.8,42.1
92655,8337,4111,4226,36.9,36.3,37.5
92656,49046,23506,25540,35.5,34.9,36
92657,9741,4709,5032,43.8,45,42.7
92660,34797,16839,17958,44.2,43.4,45
92661,3744,1981,1763,44.7,43.2,46.3
92662,2756,1230,1526,56.8,57.2,56.4
92663,21649,11377,10272,38,36.3,40
92672,34464,17412,17052,40.2,38.9,41.6
92673,29309,14613,14696,39.1,38.6,39.5
92675,34731,17225,17506,40.3,38.5,41.9
92676,1945,989,956,47.8,48,47.6
92677,63297,30676,32621,42.7,41.6,43.6
92678,494,247,247,42.6,42.9,42.3
92679,32611,16169,16442,40.5,40.2,40.8
92683,89747,44391,45356,38.7,38,39.4
92688,43792,21311,22481,35.2,33.8,36.3
92691,47582,23526,24056,40.8,39,42.5
92692,47222,22763,24459,43.4,42,44.6
92694,21944,10833,11111,32,31.9,32.1
92701,53908,27732,26176,27,27,27.1
92703,65445,34003,31442,29.1,28.8,29.5
92704,88123,44951,43172,29.8,29.2,30.5
92705,44706,22017,22689,37.8,36.2,39.2
92706,36457,18347,18110,30.6,29.6,31.7
92707,59492,30423,29069,28.9,28.7,29.2
92708,56004,27295,28709,42.3,40.9,43.7
92780,57741,28156,29585,32.8,31.7,33.9
92782,23032,11090,11942,36.1,35.6,36.5
92801,62068,30793,31275,30.9,29.9,32
92802,42709,21360,21349,30.6,29.8,31.5
92804,85914,42316,43598,33,32,34
92805,70401,35868,34533,29,28.8,29.3
92806,37173,18685,18488,32.1,31.2,33.1
92807,36171,17695,18476,41.9,40.8,42.9
92808,20039,9761,10278,39.7,38.6,40.6
92821,35533,17338,18195,38.7,37.1,40.2
92823,3613,1757,1856,38.6,38.7,38.6
92831,34204,16728,17476,29.7,29.6,29.8
92832,24752,12419,12333,31.7,31.1,32.4
92833,51767,25643,26124,36,35.2,36.9
92835,24010,11414,12596,43.5,41.4,45.4
92840,54083,26955,27128,34.5,33.5,35.4
92841,32845,16368,16477,37.1,36.4,37.8
92843,45214,22754,22460,33.9,33.3,34.4
92844,24307,12148,12159,36.1,35.5,36.7
92845,16333,7965,8368,42.1,40.8,43.1
92860,27198,15702,11496,39.5,38.7,40.7
92861,5781,2854,2927,49.6,49.3,49.9
92865,19704,9788,9916,35.4,34,36.6
92866,14885,7139,7746,34.4,33.2,35.8
92867,44515,22134,22381,34.4,33.5,35.1
92868,25404,13933,11471,30.9,29.9,32.4
92869,37184,18433,18751,38.4,36.7,39.9
92870,52033,25617,26416,36.2,34.5,37.9
92879,46745,23130,23615,31.1,30.1,32.2
92880,58763,29140,29623,31.5,31,32
92881,30991,15202,15789,35.3,33.8,36.4
92882,67917,33742,34175,31.8,30.8,32.6
92883,29301,14411,14890,36.1,36,36.2
92886,46564,22582,23982,41.7,40.8,42.5
92887,20006,9803,10203,41.6,40.6,42.4
93001,32990,16773,16217,37.4,36.9,38
93003,50474,24818,25656,39.7,37.7,41.5
93004,29149,14170,14979,39.5,37.6,41.2
93010,42901,21109,21792,40.8,39,42.7
93012,34617,16481,18136,41.4,39.9,42.9
93013,16091,7949,8142,40.7,38.9,42.6
93015,17334,8681,8653,32.2,31.3,33.1
93021,36422,18098,18324,35,34.1,35.8
93022,6106,3062,3044,42.3,41.7,42.8
93023,20589,9805,10784,46.8,45.3,48.1
93030,59372,30038,29334,29.5,28.9,30.1
93033,82728,42604,40124,27.8,27.4,28.3
93035,27732,14006,13726,39.1,38.2,39.9
93036,41691,20812,20879,30.3,29.8,30.9
93040,2031,1052,979,29.3,29.3,29.3
93041,23641,12046,11595,30.1,28.5,31.9
93042,56,52,4,28.9,29,28.5
93043,333,274,59,29.5,29.7,28.8
93060,32811,16540,16271,31.2,30.3,32.2
93063,54366,26592,27774,39,37.8,40.1
93064,40,21,19,39,39.5,38.5
93065,72508,35772,36736,37.1,36.2,38
93066,3102,1586,1516,44.1,44.3,43.9
93067,895,424,471,43.6,41.8,45.1
93101,31683,15998,15685,31.6,31.1,32.3
93103,20249,10442,9807,36.1,35.6,36.8
93105,24815,11815,13000,46.2,44.2,48
93108,11112,5184,5928,51.3,51.2,51.4
93109,10858,5459,5399,42.2,40.4,44
93110,16829,8391,8438,42.4,39.4,45.5
93111,17370,8350,9020,45.2,43.6,46.6
93117,53217,26703,26514,22.4,22.7,22
93201,1348,690,658,24.2,24.5,24
93202,4143,1992,2151,28.4,27.1,29.4
93203,20938,10875,10063,24.2,24,24.5
93204,15529,11241,4288,34.3,36.8,25
93205,2113,1070,1043,50.4,51.1,49.5
93206,2300,1227,1073,26.9,26,27.4
93207,263,132,131,58.9,57,59.8
93208,104,55,49,57,59.5,56.5
93210,19504,12838,6666,34.7,36.1,31.1
93212,26079,19186,6893,34.9,36.2,28.4
93215,55659,33133,22526,28.5,28.9,27.3
93218,994,516,478,29.8,29.8,29.8
93219,10194,5225,4969,23.8,23.4,24.3
93220,211,108,103,26.5,28.3,25.3
93221,14945,7374,7571,34.2,32.6,35.6
93222,2099,1065,1034,51.5,51.5,51.5
93223,10604,5343,5261,26.2,26,26.6
93224,451,226,225,41.4,40.5,41.8
93225,5077,2585,2492,44,44.1,43.9
93226,282,135,147,54.7,56.5,54.1
93230,65264,32209,33055,31.4,30.4,32.4
93234,6987,3693,3294,24.9,24.8,25
93235,4559,2341,2218,27.5,27.5,27.5
93238,1490,738,752,55.5,54.8,56.2
93239,1688,886,802,26.1,25.5,26.6
93240,6056,2971,3085,50.5,49.4,51.6
93241,17489,9258,8231,24.6,24.6,24.6
93242,3468,1817,1651,30.8,30.1,31.6
93243,1699,884,815,40.9,41,40.8
93244,534,272,262,45.3,45.8,44.8
93245,37412,19344,18068,26.7,25.9,27.9
93247,17423,8818,8605,26.4,25.6,27.2
93249,2739,1559,1180,22.7,23.5,21.2
93250,13522,7572,5950,25.9,26.4,24.9
93251,270,143,127,38.5,35.8,39.8
93252,4176,3301,875,38.4,38.3,38.9
93254,811,420,391,35.1,33.3,35.8
93255,614,297,317,54.5,54.9,54.1
93256,5753,2959,2794,24,23.6,24.4
93257,75004,37366,37638,29.1,28.2,29.8
93258,2046,1044,1002,23.5,22.2,25.2
93260,200,105,95,56.5,57.5,55.8
93261,3099,1637,1462,22.8,22,23.8
93262,63,41,22,26.5,26.3,27.5
93263,19582,10046,9536,26.2,26.1,26.3
93265,3699,1859,1840,51.2,49.9,52.2
93266,1587,804,783,28.4,28.6,28.1
93267,6237,3150,3087,27.5,27.3,27.8
93268,16897,8877,8020,30,29.1,31.1
93270,5837,3027,2810,29.5,29.5,29.5
93271,2276,1129,1147,52.3,51.7,53.2
93272,3583,1877,1706,25,24.6,25.3
93274,69721,34546,35175,29.2,28.3,30.1
93276,161,83,78,32.5,40.3,29
93277,50607,24308,26299,34.5,32.6,36.3
93280,27152,16585,10567,28.3,29.2,26.3
93283,2040,1002,1038,50.3,51.1,49.6
93285,2536,1266,1270,58.3,58.7,57.9
93286,9548,4826,4722,29,28.2,29.8
93287,119,66,53,50.2,50.3,49.5
93291,52849,26896,25953,29.1,28.8,29.5
93292,39032,19207,19825,31.9,31.1,32.7
93301,12248,5825,6423,30.9,30.3,31.5
93304,48731,23995,24736,28.6,27.4,29.8
93305,37601,19042,18559,26.7,26.2,27.3
93306,64587,31613,32974,30.6,29.4,31.9
93307,82658,41331,41327,25.6,25.2,25.9
93308,52447,26239,26208,33.6,32.4,34.8
93309,58409,27921,30488,31.5,30.1,33
93311,40829,19997,20832,32.7,31.8,33.7
93312,56741,27941,28800,32.7,31.9,33.5
93313,43553,21687,21866,29.3,28.3,30.3
93314,22393,11175,11218,36,35.8,36.2
93401,28033,14149,13884,34.1,32.1,37.3
93402,14318,6995,7323,47.2,44.2,49.3
93405,35440,22290,13150,23.1,24.8,21.6
93410,0,0,0,0,0,0
93420,28413,13809,14604,47,45.4,48.6
93422,31375,15869,15506,41.8,40.7,43
93424,1261,591,670,59.3,58.7,59.7
93426,1401,770,631,45.4,43.5,47.5
93427,5505,2708,2797,39.8,38.6,40.9
93428,6314,3019,3295,56.8,56.1,57.4
93429,154,79,75,43,40.9,45.2
93430,2972,1436,1536,52.3,51.2,53.5
93432,1384,707,677,47,46.5,47.4
93433,13162,6439,6723,36.8,35,38.9
93434,7110,3580,3530,28.2,26.7,29.4
93436,54017,28423,25594,35.7,35.2,36.5
93437,3338,1807,1531,22.5,22,23.4
93440,2058,1040,1018,38.8,36.8,40
93441,1530,773,757,42.1,40.9,43.7
93442,10789,5270,5519,49,46.1,51.5
93444,19244,9518,9726,39.7,38.7,40.7
93445,7173,3632,3541,35.1,33.9,36.3
93446,43714,21423,22291,38.8,37.1,40.3
93449,7657,3700,3957,51.8,50.1,53.3
93450,740,394,346,27.5,27.9,27
93451,3779,1926,1853,34.8,34.1,35.4
93452,524,271,253,44,40.8,45.8
93453,2899,1487,1412,45.7,45.8,45.7
93454,36448,18056,18392,31.8,30.6,33.1
93455,41684,20391,21293,40.3,38.6,41.7
93458,55431,28604,26827,26.1,25.7,26.6
93460,5255,2602,2653,48.3,47.5,49
93461,1623,832,791,31.4,30.7,31.9
93463,7646,3682,3964,47,45.5,48.3
93465,9153,4428,4725,42,40.5,42.9
93501,5467,2781,2686,34.9,34.1,35.8
93505,14038,8292,5746,34.7,35.2,33.5
93510,7993,4086,3907,45.2,44.8,45.4
93512,277,138,139,47.1,47,47.2
93513,1763,879,884,46.2,43.7,47.1
93514,13857,6918,6939,45.4,44.3,46.5
93516,2299,1186,1113,39.4,39.2,39.7
93517,670,346,324,46.1,46.4,45.4
93518,1146,576,570,53.6,54.5,53.1
93519,101,54,47,53.8,56,52.5
93522,48,31,17,61.5,58.8,62.5
93523,3074,1531,1543,27,27.7,26.2
93524,229,168,61,22,22,22
93526,719,372,347,51.9,49.8,52.7
93527,2387,1206,1181,49.7,50.1,49.3
93528,172,90,82,55,54.7,56
93529,633,344,289,41.5,41.4,41.7
93530,47,28,19,56.4,59,48.8
93531,509,248,261,52.5,52.3,52.7
93532,2932,1642,1290,41.7,39.2,44.1
93534,39341,18601,20740,31.1,29.7,32.5
93535,72046,34879,37167,28.3,27,29.5
93536,70918,37804,33114,34.4,33.3,35.7
93541,449,228,221,37.7,38,37.3
93543,13033,6695,6338,32.9,31.5,34
93544,1259,689,570,52.4,51.7,53.3
93545,2082,1035,1047,42.7,41.8,44.1
93546,9567,5199,4368,34.4,34.6,34.2
93549,344,188,156,47.2,48.2,44.8
93550,74929,36414,38515,27.5,26.1,28.8
93551,50798,25056,25742,37,35.7,38.1
93552,38158,18711,19447,28.4,27.1,29.6
93553,2138,1121,1017,43.3,42.5,44.3
93554,72,30,42,59,60,58
93555,32560,16372,16188,35.7,34.5,37.1
93558,125,74,51,57.1,58,56.5
93560,18910,9491,9419,32.4,31.7,32.9
93561,34630,20193,14437,39.7,37.7,43.5
93562,1818,924,894,40.7,40.4,41.2
93563,388,263,125,44.5,44.4,44.8
93591,7285,3653,3632,30.9,30.1,31.7
93592,64,35,29,51,58.3,45.5
93601,1909,956,953,50.3,49.6,51
93602,3862,1943,1919,47.3,46.4,48
93603,222,114,108,51.8,53,51
93604,674,326,348,60.8,56,62.9
93605,175,81,94,37.6,42.5,31.5
93606,1217,624,593,24.2,24,24.8
93608,1114,608,506,26.7,27.3,26.1
93609,5640,2889,2751,29.9,29.1,30.6
93610,23833,8280,15553,34.2,30.6,35.4
93611,45614,22114,23500,36.5,35.1,37.8
93612,35351,16956,18395,31.2,29.8,32.9
93614,11661,5722,5939,49.8,49.5,49.9
93615,6042,3206,2836,25.3,25.6,25
93616,2627,1340,1287,29.4,28.8,29.9
93618,28262,14523,13739,27.7,27.1,28.4
93619,28965,14230,14735,38.3,38.2,38.4
93620,9591,4841,4750,31.4,30.5,32.3
93621,464,223,241,44,46.4,41.5
93622,9581,4989,4592,27.2,26.4,27.9
93623,69,34,35,50.3,52.3,48.8
93624,1134,605,529,24.8,23.9,25.5
93625,7313,3681,3632,32.4,31.7,33
93626,1359,711,648,49.5,49.5,49.4
93627,123,60,63,26.5,26.5,26.5
93628,327,159,168,24.6,23.8,25.2
93630,19162,9707,9455,29,28.7,29.3
93631,15941,7822,8119,34.3,33,35.4
93633,25,14,11,46.8,50,46.8
93634,33,21,12,40.3,40.3,41
93635,38776,19413,19363,30.2,29.3,31.1
93636,11908,5983,5925,42.7,42.3,42.9
93637,37743,18871,18872,29.9,28.8,30.8
93638,49068,25624,23444,26,25.7,26.4
93640,11880,6560,5320,26.1,26.8,25.1
93641,595,352,243,47.6,44,50.3
93643,3171,1576,1595,51,51.4,50.6
93644,8637,4196,4441,50.4,49,52
93645,318,156,162,49,47.3,50.3
93646,10557,5315,5242,23.9,23.7,24.1
93647,11874,6164,5710,26.3,26.1,26.6
93648,15719,8082,7637,25.7,25.8,25.6
93650,4055,1930,2125,28.8,26.4,31
93651,1674,833,841,46.4,47.1,45.6
93652,415,232,183,26.4,24.7,27.4
93653,1229,627,602,49.5,48.7,51.1
93654,29776,15189,14587,30.3,29.3,31.4
93656,6313,3221,3092,28.5,27.8,29.4
93657,34999,17474,17525,32.1,31.3,32.9
93660,4675,2378,2297,23.8,24.2,23.4
93662,30237,15281,14956,30.2,29.4,31.1
93664,585,307,278,53.1,52.6,53.4
93665,472,231,241,27.8,28.3,27.4
93666,692,352,340,25.5,27.2,23.8
93667,2604,1341,1263,42,41.7,42.3
93668,1118,583,535,32.7,32.1,33.2
93669,295,145,150,50.9,49.8,52
93673,713,368,345,29.7,31.7,27.8
93675,3721,1898,1823,46.4,45.7,47
93701,12529,6404,6125,24.2,24.2,24.1
93702,48607,24493,24114,24.4,24.2,24.6
93703,31868,15812,16056,28,27.2,28.9
93704,27156,13125,14031,37,34.4,39.5
93705,36703,17566,19137,29.3,27.9,30.7
93706,41087,21022,20065,27.1,26.7,27.4
93710,30202,14350,15852,27.7,27.2,28.4
93711,36731,17551,19180,42.7,40.4,45.1
93720,45191,21362,23829,37.4,35.4,39
93721,6959,4620,2339,32.6,32.5,33
93722,76448,37520,38928,29.5,28.5,30.4
93723,9547,4824,4723,33.4,33.3,33.6
93725,24979,12649,12330,27.9,27.4,28.4
93726,40705,19761,20944,28.6,27.5,29.8
93727,71820,35265,36555,28.7,27.9,29.6
93728,15743,7932,7811,32.7,32,33.4
93730,9941,4864,5077,39.6,38.5,40.5
93901,26863,13056,13807,36.2,34.3,38
93905,61087,31768,29319,25.5,25.3,25.7
93906,59461,29675,29786,30.2,29.3,31
93907,21726,10897,10829,37.5,36.4,38.5
93908,13043,6479,6564,44.9,44.6,45.1
93920,1369,732,637,44.5,46.1,42.6
93921,3281,1428,1853,59.4,58.8,59.7
93923,12073,5521,6552,58.9,57.7,59.7
93924,6279,3088,3191,51.6,51.7,51.4
93925,1671,851,820,28.1,26.5,29.5
93926,8726,4473,4253,27.2,26.7,27.9
93927,17547,9165,8382,26,25.5,26.5
93928,506,368,138,32.3,32,34.3
93930,15866,8438,7428,27.3,26.8,28.1
93932,592,294,298,45.3,47.1,43.6
93933,22406,10711,11695,32.7,31.6,33.8
93940,31615,15852,15763,38.5,35.9,41.4
93943,6,3,3,42.5,52.5,32.5
93950,15046,6924,8122,48.1,45.2,50.1
93953,4509,2167,2342,57.8,57.4,58.2
93954,302,155,147,27.5,27.8,27.4
93955,33359,16738,16621,30.6,30.2,31.1
93960,27080,18747,8333,34.9,37.1,28.5
93962,673,326,347,39.4,38,40.2
94002,25992,12694,13298,40.9,40.1,41.7
94005,4282,2148,2134,41.7,41.9,41.5
94010,40737,19498,21239,42.3,41.7,42.9
94014,47014,23329,23685,37.5,35.7,39.4
94015,60927,29916,31011,39.1,37.2,40.9
94019,18424,9079,9345,42.3,41.1,43.5
94020,1559,822,737,48.6,48.6,48.6
94021,192,94,98,38,37.8,39
94022,18500,8937,9563,48.2,47.8,48.7
94024,22385,10940,11445,46.3,46.3,46.2
94025,40526,19730,20796,39,38.2,39.6
94027,7089,3472,3617,48.3,47.6,48.8
94028,6534,3234,3300,50,49.2,50.8
94030,21536,10202,11334,44.8,43.2,46.1
94037,2913,1401,1512,46,44.9,46.8
94038,3040,1515,1525,43.1,42.3,43.9
94040,32996,16752,16244,35.7,34.6,37
94041,13292,6853,6439,35.3,34.9,35.8
94043,28358,14373,13985,36.2,35.5,37
94044,37296,18231,19065,41.5,40.3,42.8
94060,1554,843,711,38,38.4,37.3
94061,36245,17727,18518,37,35.5,38.4
94062,25876,12710,13166,44.8,44.4,45.2
94063,30949,16512,14437,31,30.6,31.5
94065,11359,5423,5936,40.1,39.6,40.6
94066,41130,20267,20863,38.8,37.5,40.2
94070,29166,14087,15079,42.7,42,43.5
94074,214,121,93,43,42.3,45.3
94080,63975,31577,32398,38.1,36.5,39.7
94085,21247,11157,10090,32.1,32.2,32
94086,45697,23409,22288,33.8,33.7,34
94087,54293,26705,27588,38.8,38.3,39.3
94089,19245,9497,9748,37.4,36,39.3
94102,31176,18681,12495,40.9,42.7,38.2
94103,27170,16322,10848,39.3,39.8,38
94104,406,218,188,47.6,47.4,47.8
94105,5846,3287,2559,35.5,36.4,34.3
94107,26599,14337,12262,36.2,36.8,35.4
94108,13768,6648,7120,43.8,42.9,44.6
94109,55984,28503,27481,37.6,38.4,36.7
94110,69333,36429,32904,36.2,36.2,36.1
94111,3713,1980,1733,51.4,50.1,53.2
94112,79407,39385,40022,39.8,38,41.7
94114,31124,18396,12728,40.4,42.1,37.5
94115,33021,15503,17518,36.9,36.9,36.9
94116,43698,21178,22520,43.3,41.6,45
94117,39169,19906,19263,33.8,35.4,32
94118,38319,18071,20248,38.6,37.8,39.4
94121,41203,19801,21402,42.4,41.2,43.6
94122,56023,27152,28871,39.1,38.4,39.8
94123,23088,10648,12440,35,35.6,34.3
94124,33996,16591,17405,34.6,33.5,35.8
94127,19289,9682,9607,45.6,44.7,46.5
94128,69,50,19,46.5,49,41.5
94129,3183,1665,1518,30,30.3,29.6
94130,2880,1561,1319,26.2,26.3,26.1
94131,26881,14061,12820,42.3,42.9,41.4
94132,28129,12994,15135,32.9,33,32.8
94133,26237,12907,13330,43.9,42.3,45.5
94134,40798,19930,20868,39.5,37.7,41.2
94158,4792,2623,2169,33.1,33.9,31.9
94301,16995,8443,8552,43.2,41.4,44.9
94303,45467,22629,22838,32.4,31.3,33.6
94304,3627,1745,1882,39.6,38.4,41.3
94305,13862,7512,6350,22.6,22.9,22.1
94306,26469,12933,13536,41.4,39.7,42.7
94401,34429,17254,17175,36.1,34.7,37.9
94402,23981,11638,12343,42.2,40.9,43.6
94403,39642,19142,20500,39.6,38.3,40.9
94404,33749,16234,17515,39.5,38.5,40.5
94501,60212,28814,31398,40,38.6,41
94502,13600,6501,7099,44.9,43.6,45.9
94503,19681,9641,10040,35.6,34,36.8
94505,13403,6735,6668,39.6,40.1,39
94506,22452,10896,11556,43.4,43.5,43.4
94507,14889,7386,7503,47.9,47.9,47.9
94508,3661,1847,1814,27.6,26.9,28.3
94509,62439,30455,31984,33.8,32.5,35
94510,27088,13036,14052,42.9,41.8,43.9
94511,2137,1143,994,52.8,53,52.5
94512,108,60,48,47,51,42.5
94513,54605,26575,28030,35.9,34.7,36.9
94514,1360,722,638,33,31.3,35.8
94515,7050,3551,3499,43.4,41.5,45.4
94516,211,116,95,43.6,43.3,44.3
94517,12385,6079,6306,45.1,44.5,45.6
94518,26778,13226,13552,40.6,38.6,42.6
94519,18453,9199,9254,38.5,37,39.9
94520,37208,19255,17953,31.1,30.5,31.9
94521,41249,19781,21468,41.1,39.9,42.3
94523,33569,16276,17293,40.7,38.7,42.6
94525,3127,1530,1597,45.7,45.2,46.1
94526,31102,15092,16010,45.5,44.8,46
94528,964,472,492,50.7,50.8,50.6
94530,23877,11472,12405,43.6,41.6,45.6
94531,40290,19547,20743,33.7,32.2,34.9
94533,69277,33947,35330,33.1,31.6,34.7
94534,36416,17857,18559,39.3,38.7,39.9
94535,3793,2129,1664,22.1,22.1,22.2
94536,68790,34019,34771,36.6,36,37.2
94538,61148,30703,30445,34.4,34,35
94539,50031,24807,25224,40.8,40.4,41
94541,61635,30594,31041,34,33.2,34.9
94542,12717,6196,6521,34.5,34.6,34.4
94544,73026,36245,36781,32.3,31.4,33.2
94545,29707,14590,15117,36.8,35.3,38.3
94546,42209,20219,21990,41.2,40,42.4
94547,24092,11416,12676,39,37.3,40.5
94548,412,229,183,42.5,41.9,42.6
94549,26864,13046,13818,45.9,45.1,46.5
94550,46896,23071,23825,40.7,40.1,41.2
94551,36867,18559,18308,35.9,35.2,36.8
94552,14454,7026,7428,43.3,43.2,43.3
94553,47065,23215,23850,41.9,40.5,43.2
94555,34143,16923,17220,36.3,36.4,36.1
94556,15229,7259,7970,47,46.3,47.4
94558,66830,33449,33381,41.1,39.5,42.7
94559,27184,13640,13544,35.7,34.5,37.2
94560,42573,21217,21356,35.4,34.4,36.5
94561,36515,18183,18332,32.2,31.5,32.8
94563,17672,8583,9089,47.8,47.6,48
94564,18287,8690,9597,42.6,40.5,44.2
94565,84641,41479,43162,31.8,30.7,32.8
94566,40884,19896,20988,42.2,41.4,42.9
94567,623,302,321,39.8,39.5,40.1
94568,46016,23972,22044,35.3,34.7,35.9
94569,198,97,101,53.3,53.5,53.3
94571,7911,3841,4070,56.3,55.8,56.8
94572,8684,4239,4445,38.1,36.3,39.7
94573,94,50,44,46,48.5,45.5
94574,8742,4188,4554,45.3,43.4,47.1
94575,974,391,583,19.6,19.8,19.6
94576,164,70,94,49.5,49,50
94577,45560,21851,23709,39.5,37.9,40.9
94578,38558,18756,19802,34,33.1,35.1
94579,20571,9929,10642,40.8,39.2,42.3
94580,27152,13261,13891,37.3,35.9,38.5
94582,38537,18934,19603,35.9,35.9,35.9
94583,34859,17136,17723,39,38,39.9
94585,28263,13974,14289,33,32,34
94586,925,466,459,49.2,48.4,49.7
94587,69516,34318,35198,36.2,34.9,37.5
94588,30842,15271,15571,38.8,38.1,39.4
94589,29876,14542,15334,36.9,34.6,39.1
94590,35420,17214,18206,36.1,34.4,37.7
94591,53042,25772,27270,39.3,37.6,40.7
94592,742,364,378,35.1,36.6,33.4
94595,16425,6703,9722,66.9,61.8,70.1
94596,20037,9902,10135,39.8,38.4,41.2
94597,20277,9750,10527,39.2,37.6,40.7
94598,25818,12335,13483,47.2,46.1,48.1
94599,3021,1735,1286,63.8,66.3,60.6
94601,50294,25820,24474,30.9,30.4,31.7
94602,28329,13180,15149,41.3,40.2,42.4
94603,31403,15430,15973,29.7,28.8,30.6
94605,39016,18297,20719,38.1,36.2,39.5
94606,36672,18044,18628,35.5,35.2,35.7
94607,24978,12585,12393,36,35.3,36.6
94608,28019,13883,14136,35.5,35.4,35.7
94609,20596,9799,10797,34.6,34.6,34.7
94610,29287,13633,15654,39.5,39.5,39.6
94611,36565,17345,19220,43.9,43.5,44.2
94612,14389,7476,6913,40.2,40.8,39.2
94613,715,74,641,20.6,22.8,20.6
94618,16046,7464,8582,41.5,41.6,41.4
94619,23299,10841,12458,40.5,39,41.8
94621,29870,14789,15081,28.8,28,29.7
94702,15979,7520,8459,39.5,37.6,41.2
94703,19846,9743,10103,35.7,34.2,37.1
94704,25592,12851,12741,21.7,22,21.4
94705,12762,6081,6681,42.7,41.8,43.4
94706,19615,9322,10293,37.3,36.1,38.6
94707,11710,5482,6228,50.4,49.8,51
94708,10985,5334,5651,50.4,49.4,51.5
94709,11806,6083,5723,27.8,27.8,27.8
94710,6948,3469,3479,36.3,35.3,37.5
94720,2964,1398,1566,19.8,19.9,19.7
94801,29395,14759,14636,31.2,30.9,31.5
94803,24904,12127,12777,42.3,41.4,43.2
94804,38559,18513,20046,34.3,32.9,35.6
94805,13648,6583,7065,40,38.8,41.1
94806,59861,29365,30496,33.2,32,34.4
94850,0,0,0,0,0,0
94901,41157,21229,19928,37.9,36.3,39.8
94903,29040,13566,15474,46.9,43.9,49.4
94904,11995,5502,6493,48.8,47.3,49.8
94920,12474,5798,6676,49,48.5,49.5
94922,425,215,210,44.3,44.5,44
94923,1411,721,690,57.3,57.4,57.3
94924,1638,878,760,49.2,48.1,50.8
94925,9253,4316,4937,44.2,43.1,45
94928,43170,20731,22439,31.1,30.7,31.7
94929,264,129,135,58.3,58.5,57.8
94930,8500,4144,4356,46.1,45.6,46.5
94931,8470,4056,4414,37.8,36.2,39.1
94933,865,422,443,48.5,48.9,47.9
94937,837,385,452,54.7,54.8,54.5
94938,812,399,413,48.3,47.9,48.5
94939,6859,3182,3677,46.5,45.6,47.2
94940,268,138,130,54,49.5,55
94941,30496,14417,16079,45.5,45.2,45.8
94945,17167,8447,8720,44.7,43.3,45.9
94946,699,365,334,47.7,47.1,48.4
94947,24283,11659,12624,44.1,42.6,45.3
94949,17202,8291,8911,41.7,39.4,43.7
94950,89,46,43,51.5,53,50.8
94951,4124,2072,2052,45.2,45.1,45.4
94952,32858,16353,16505,42.1,40.4,44
94954,37365,18336,19029,39.4,37.6,41
94956,1756,801,955,51.1,49.4,52.7
94957,1332,639,693,46.4,46.6,46.1
94960,15740,7399,8341,45.3,44.9,45.7
94963,569,275,294,51.4,52.8,49.9
94964,5094,4970,124,40.8,40.8,44
94965,10847,5113,5734,47.9,47.7,48
94970,683,336,347,55.4,55.8,54.6
94971,337,156,181,49.8,49.2,50.3
94972,52,30,22,30.8,31,30.7
94973,1429,690,739,50.4,49.9,51.1
95002,2077,1060,1017,35.4,34.5,36.5
95003,23974,11609,12365,46.2,45.4,47
95004,3918,1963,1955,43.8,43.3,44.2
95005,6311,3202,3109,43.7,43,44.7
95006,8979,4662,4317,46,45.9,46.1
95007,676,350,326,40.6,40.3,41.2
95008,45260,22235,23025,38.5,37.4,39.6
95010,9137,4319,4818,42.2,39.4,45
95012,10320,5264,5056,27.8,27.3,28.4
95013,80,46,34,38.6,40.5,35
95014,60717,30006,30711,39.5,39.2,39.8
95017,834,459,375,43.4,43.5,43.4
95018,7778,3907,3871,43.5,43.2,43.8
95019,7727,3842,3885,28.3,27.5,29.2
95020,57349,28607,28742,33.3,32.6,33.9
95023,48841,24428,24413,33.4,32.3,34.3
95030,12791,6189,6602,48.1,47.9,48.2
95032,25089,12107,12982,43.7,42.6,44.5
95033,9372,4843,4529,46.7,47.2,46.3
95035,66943,34220,32723,36.1,35.4,36.9
95037,45579,22688,22891,38,37,38.9
95039,1377,708,669,35.6,35.3,35.9
95041,160,74,86,36,37,35.5
95043,639,321,318,48.4,48.5,48.3
95045,4046,2005,2041,40.7,40.9,40.5
95046,6417,3258,3159,38.7,39,38.5
95050,35923,18083,17840,33.9,33,34.9
95051,54327,27294,27033,35.9,35.6,36.4
95053,2206,1027,1179,19.7,19.7,19.6
95054,23364,12068,11296,32.9,33.1,32.7
95060,46377,23805,22572,34.7,34.2,35.3
95062,36079,17816,18263,38.5,36.9,40.2
95064,7331,3409,3922,19.7,19.7,19.6
95065,8113,3975,4138,42.9,41.9,44.2
95066,14749,7251,7498,42.4,41.5,43.4
95070,30617,14984,15633,47.8,47.5,48
95073,10154,4982,5172,45,43.2,46.4
95075,331,177,154,43.7,43.5,44
95076,82474,41745,40729,31.1,30.2,32.3
95110,18730,10739,7991,31.7,32,31.3
95111,58466,29503,28963,31.8,31.2,32.4
95112,55927,30066,25861,30.4,30.5,30.1
95113,893,474,419,38,35.6,43.5
95116,51496,26326,25170,30.8,30.2,31.4
95117,30067,15205,14862,33.6,32.6,34.6
95118,31932,15675,16257,37.4,36.3,38.4
95119,9970,5024,4946,36.8,36.2,37.5
95120,37457,18609,18848,44.4,44.2,44.5
95121,37469,18692,18777,35.3,34.2,36.3
95122,56545,29089,27456,30.1,29.6,30.8
95123,62228,30603,31625,35.9,34.9,36.9
95124,47082,23336,23746,39.7,39,40.3
95125,51939,25128,26811,39.9,38.9,40.7
95126,31049,15733,15316,33.3,33,33.6
95127,61325,31309,30016,32.9,31.8,34.1
95128,34836,17398,17438,35.1,34.7,35.6
95129,38720,19031,19689,39.4,38.6,40.1
95130,13911,6935,6976,38.2,37.8,38.7
95131,28565,14352,14213,35.8,35.3,36.2
95132,40299,20147,20152,38.3,37.3,39.4
95133,25401,12512,12889,36.1,35.3,36.9
95134,15268,7940,7328,31.9,32.5,31.2
95135,20120,9630,10490,43.5,42.9,44.1
95136,42989,21069,21920,34.8,34.3,35.4
95138,18889,9223,9666,36.7,36.9,36.4
95139,6748,3394,3354,37.4,36.9,37.9
95140,191,110,81,47.3,48,46.8
95148,45528,22756,22772,36.6,35.9,37.3
95202,6521,3279,3242,35.8,36,35.6
95203,15696,8150,7546,32,31.7,32.2
95204,27786,13269,14517,37.6,35.4,39.5
95205,38069,19648,18421,27.6,27.1,28.3
95206,65004,32466,32538,27.7,26.6,28.9
95207,47965,22686,25279,31.9,29.9,33.9
95209,39488,19105,20383,35.5,33.5,37.4
95210,39009,18906,20103,29.1,27.7,30.4
95211,1545,694,851,19.6,19.6,19.5
95212,25239,12493,12746,32.6,31.6,33.5
95215,23224,12143,11081,31.8,30.2,33.7
95219,27884,13417,14467,36,35,36.8
95220,7273,3693,3580,42.3,41.1,43.3
95222,5292,2583,2709,47.9,46.9,48.8
95223,4612,2376,2236,54.5,54.4,54.6
95224,429,227,202,46.9,44.4,48.7
95225,672,340,332,47.8,48,47.7
95226,84,42,42,42,41.7,43
95227,941,477,464,47.7,47.3,48.4
95228,3976,2009,1967,46.8,46.4,47.3
95230,718,362,356,40.4,41.4,37.9
95231,4374,2720,1654,30.5,29.5,32.8
95232,304,146,158,53.3,54.5,53
95233,436,220,216,49,50.3,47.7
95234,70,40,30,25.5,29,20.5
95236,4223,2112,2111,37.8,38.1,37.6
95237,3167,1644,1523,39.8,37.1,42.8
95240,47172,23396,23776,32.5,31.2,33.7
95242,25393,12279,13114,41.5,39.9,43
95245,2277,1149,1128,52.6,52.7,52.4
95246,1615,837,778,55.5,55.2,55.8
95247,4368,2131,2237,54.3,52.6,55.9
95248,301,138,163,53.3,53.5,52.8
95249,4042,2006,2036,46.6,41.9,50.5
95250,78,41,37,57.5,61.5,55.5
95251,767,367,400,47,46.6,47.6
95252,13460,6807,6653,45.1,44.8,45.3
95254,480,228,252,48.8,50.4,46
95255,2042,1016,1026,52.9,52.7,53.1
95257,413,202,211,53,54.3,52.3
95258,4018,1978,2040,42.9,42.5,43.5
95301,37073,19002,18071,31.8,30.8,33
95303,912,472,440,30.9,31.3,30.6
95304,15706,9805,5901,37.2,36.3,38.8
95305,245,124,121,49.1,48.3,49.5
95306,970,507,463,48.4,48.8,47.8
95307,42753,21163,21590,30,29.2,30.8
95310,1882,944,938,53.1,51.6,54.5
95311,2197,1117,1080,53,53,53
95312,268,134,134,31.6,31.7,31.5
95313,1386,732,654,35.6,35.3,36.1
95314,0,0,0,0,0,0
95315,13018,6617,6401,28.1,27.7,28.5
95316,6573,3263,3310,35.9,34.8,37.2
95317,817,435,382,29.2,29.8,28
95318,541,268,273,39.5,41.6,37.8
95319,1749,878,871,31.8,30.1,33.3
95320,12819,6427,6392,36.7,35.7,38
95321,3736,1863,1873,57,57.4,56.5
95322,8942,4585,4357,33.8,32.5,35
95323,1260,629,631,33.9,33.3,34.5
95324,7324,3664,3660,35.9,34.1,37.5
95325,81,43,38,45.8,46.5,45.7
95326,9581,4728,4853,34.6,33.6,35.6
95327,9806,6657,3149,40.9,38.9,49
95328,3993,2016,1977,26.7,26.4,27.1
95329,2460,1265,1195,49.9,50.2,49.6
95330,17853,8928,8925,30.6,30.1,31.1
95333,2942,1491,1451,33.2,32.6,33.8
95334,15457,7811,7646,28,27.7,28.6
95335,541,289,252,54.3,53.1,55.6
95336,42675,21023,21652,35.2,33.7,36.6
95337,31557,15564,15993,32.6,32.1,33
95338,11062,5477,5585,50.3,49.6,50.9
95340,33931,16730,17201,32.8,30.9,34.9
95341,32967,16878,16089,25.3,25,25.6
95345,708,374,334,43.4,41.8,45.2
95346,1272,666,606,50,49,51.5
95348,30805,14928,15877,28,26.8,29.3
95350,51046,24435,26611,36.8,34.1,39.3
95351,46458,23441,23017,28.1,27.6,28.6
95354,25394,12779,12615,33,32,33.9
95355,58311,27916,30395,36.4,34.8,37.7
95356,30918,15060,15858,37.3,35.8,38.5
95357,11559,5778,5781,35.9,34,37.6
95358,31668,16380,15288,29.9,29.4,30.5
95360,11712,5834,5878,31,30.5,31.4
95361,31610,15547,16063,38.3,36.9,39.6
95363,25237,12824,12413,29.9,29.2,30.8
95364,53,27,26,45.3,46.3,39.5
95365,4985,2565,2420,26.9,26.6,27.1
95366,16575,8145,8430,37.8,36.2,39
95367,23173,11560,11613,31.2,30.4,32.1
95368,13614,6899,6715,31.1,30,32.1
95369,1099,571,528,37.1,37.5,36.8
95370,26803,13084,13719,47.9,46.4,49.2
95372,1963,996,967,42.4,40.7,44.7
95374,2030,1074,956,32.2,32.1,32.3
95375,106,58,48,58.4,57.5,59
95376,49859,24754,25105,32.3,31,33.6
95377,30902,15340,15562,32.3,31.4,33.1
95379,3898,1913,1985,43.6,42,44.8
95380,41201,20592,20609,31.3,30.2,32.5
95382,36176,17428,18748,34.3,33,35.6
95383,3937,2052,1885,51.3,50.6,52.1
95385,429,240,189,44.1,42,44.7
95386,9877,5026,4851,31.1,30,32.1
95387,636,331,305,29.1,30.1,28.4
95388,13074,6605,6469,27,26.5,27.6
95389,1272,750,522,38.1,41.7,34.6
95391,9959,4953,5006,31.5,31.5,31.6
95401,36981,18394,18587,34,32.5,35.7
95403,45164,22483,22681,36.3,34.2,38.6
95404,39761,19264,20497,40.5,39.1,42.1
95405,21399,10067,11332,42.9,40.1,45.7
95407,39352,20247,19105,30.4,29.9,30.8
95409,27187,12624,14563,49.3,45.9,52.1
95410,950,459,491,54.3,52.4,55.4
95412,401,208,193,44.1,43.8,44.4
95415,1592,854,738,36.2,36.5,35.9
95417,297,154,143,48.6,47.3,49.5
95420,374,176,198,54.9,54.8,55
95421,1592,841,751,51.5,51.6,51.4
95422,15585,7794,7791,40.3,39,41.8
95423,3747,1893,1854,54,52.9,55
95425,10841,5456,5385,41.8,40.4,43.5
95426,2147,1099,1048,50.2,50.5,49.8
95427,459,246,213,50.4,49.3,50.8
95428,2516,1277,1239,37.1,35.9,38
95429,70,39,31,55.5,55.3,57.5
95430,44,18,26,58,56.5,58.5
95431,631,367,264,52.5,52.1,52.9
95432,426,219,207,50.9,51.3,50.2
95435,82,37,45,30.7,31.5,30.3
95436,5418,2769,2649,47.4,46.6,48.3
95437,14799,7396,7403,44.3,42.5,46.3
95439,675,339,336,42.9,41.7,43.6
95441,2014,1100,914,42.1,41.3,43.9
95442,3178,1583,1595,49.8,47.9,50.7
95443,233,123,110,54.7,52.9,56.2
95444,748,355,393,43.7,39.2,46.4
95445,2093,1049,1044,51.8,51.5,52.1
95446,4750,2588,2162,49.1,48.7,49.5
95448,16852,8462,8390,43.5,41.5,45.6
95449,1507,821,686,39.2,38.6,39.7
95450,387,209,178,55.6,56.3,55.2
95451,11213,5602,5611,44.6,43.5,45.5
95452,1393,691,702,54.3,53.5,55
95453,11256,5637,5619,45.4,43.1,47.4
95454,2556,1362,1194,45.4,45.2,45.7
95456,795,356,439,59.3,56.6,60.8
95457,2893,1506,1387,49,47.7,50.8
95458,3104,1557,1547,48.7,48.4,48.9
95459,504,259,245,46.6,44.7,47.5
95460,2285,1098,1187,56.1,55.4,56.9
95461,3413,1774,1639,45.7,46.3,45
95462,1417,753,664,51.6,51.6,51.6
95463,169,88,81,52.8,52.3,53.8
95464,2673,1326,1347,45.6,44.7,46.5
95465,2083,1064,1019,50,49.5,50.7
95466,946,497,449,41.7,41.3,42.4
95467,5498,2709,2789,41.2,41.1,41.4
95468,1258,641,617,46.2,42.3,48.8
95469,1767,918,849,45.8,44.7,46.5
95470,6032,3063,2969,41.6,40.6,42.8
95471,522,279,243,47.6,48.4,47.2
95472,28255,13626,14629,48.8,47.6,49.8
95476,35394,17027,18367,44.9,42.1,47.2
95482,31808,15667,16141,36.9,35.1,38.8
95485,2557,1269,1288,43.7,43.4,43.9
95486,62,25,37,56,58.5,53.8
95488,280,149,131,50.2,51.9,48.2
95490,13264,6620,6644,41.2,39.3,43.4
95492,28532,14084,14448,37.2,35.6,38.6
95493,198,107,91,53.4,54.1,52.8
95494,139,71,68,49.5,49.8,48.5
95497,1305,624,681,63.7,64.3,63.5
95501,23976,12335,11641,35.5,35.1,36.4
95503,24152,11876,12276,41.7,39.5,44.4
95511,360,195,165,43.3,41.5,45.3
95514,254,142,112,44,48,40.7
95519,17432,8575,8857,37.4,36.2,38.7
95521,20199,10105,10094,27.6,28,26.9
95524,1787,888,899,47.6,47,48.6
95525,1733,869,864,41.7,39.5,44.3
95526,378,213,165,48.5,47.5,50.3
95527,627,345,282,51.4,49.8,54
95528,1139,584,555,45,44.4,45.3
95531,24528,13793,10735,38.2,36.6,41.3
95536,2849,1397,1452,45.8,43,47.2
95537,276,158,118,36.8,33.4,40
95540,13657,6640,7017,38.7,36.1,41.3
95542,2533,1379,1154,43.8,41.7,45.9
95543,765,406,359,52.4,50.9,53.7
95545,153,85,68,46.3,47.5,44.5
95546,3494,1729,1765,28.5,26.4,30.2
95547,1222,619,603,46,46.5,45.5
95548,1373,749,624,42.3,40.5,45.3
95549,805,426,379,46.7,47.1,46.3
95550,128,64,64,34.7,36.5,31.5
95551,1739,860,879,38.6,38.6,38.6
95552,697,366,331,50.9,50.8,51.1
95553,1062,551,511,45.9,44.3,48.6
95554,533,277,256,47.2,47.6,46.8
95555,410,219,191,48.4,48.4,48.4
95556,605,322,283,40.7,42,37.5
95558,425,234,191,48.4,47.6,49.1
95559,182,90,92,47.5,45,50
95560,1648,868,780,40.8,39.8,42.6
95562,3450,1697,1753,38.5,35.6,41.2
95563,652,340,312,49.1,48.6,49.3
95564,462,252,210,31.3,29.8,33
95565,1071,559,512,28.9,30.3,28.2
95567,1930,951,979,45.1,44.7,45.5
95568,136,68,68,48.5,48.5,48.5
95569,361,213,148,42.2,41.4,46.7
95570,2579,1318,1261,47.8,45.1,49.4
95571,271,138,133,44.9,42,45.6
95573,1744,878,866,49.6,49.9,49.3
95585,508,267,241,39.5,35.8,45.3
95587,201,109,92,49.8,50.8,49.3
95589,1612,873,739,45,42.8,46.9
95595,262,134,128,45.6,45.3,47.5
95601,198,98,100,48.6,47,50
95602,17509,8502,9007,48.2,46.7,49.6
95603,27844,13482,14362,46,43.7,48
95604,75,44,31,49.8,45.5,56.3
95605,14179,7115,7064,32.7,31.6,34.2
95606,196,103,93,40.8,40.2,42.5
95607,431,223,208,49.5,48.8,49.9
95608,59418,28017,31401,44,41.7,45.8
95610,44147,21584,22563,35.1,33.6,36.7
95612,1239,631,608,44,41.9,46.3
95614,3833,1856,1977,48.3,48.7,48
95615,834,442,392,37.9,37.3,38.2
95616,47032,21934,25098,23.4,23.7,23
95618,27281,13274,14007,28.4,27.2,29.8
95619,4842,2276,2566,42.9,39.8,45.8
95620,20553,10233,10320,33.6,32.3,34.7
95621,39819,19125,20694,37.5,35.4,39.6
95623,3806,1890,1916,48.6,48.1,49.1
95624,61989,30318,31671,35.5,33.8,37
95625,155,86,69,41.7,40,43.5
95626,5975,2994,2981,39.3,37.7,40.8
95627,3513,1758,1755,33.7,33.2,34.1
95628,40196,19572,20624,44.7,42.9,46.3
95629,832,410,422,52.9,53.6,52.5
95630,72180,38466,33714,37.6,36.8,38.9
95631,6076,3040,3036,47.9,47.8,48
95632,29269,14550,14719,34.2,33.3,35.2
95633,3349,1705,1644,48.5,48.3,48.7
95634,3232,1691,1541,47.9,47.1,49.1
95635,1262,670,592,45.8,44.3,47.2
95636,1101,573,528,46.7,46.1,47.3
95637,370,185,185,52.7,52.8,52.6
95638,2255,1164,1091,42.2,40.9,43.7
95639,283,141,142,44.4,44.1,44.7
95640,11353,7740,3613,42.1,41.7,43.5
95641,1986,1055,931,50,50.4,49.5
95642,7164,3330,3834,49.4,47,51.1
95645,2037,1082,955,35,34.6,35.8
95646,158,95,63,44.5,43.8,44.7
95648,47354,22904,24450,41.2,39.7,42.9
95650,12447,6215,6232,44.9,43.9,45.6
95651,637,336,301,46.2,46.7,45.7
95652,739,341,398,22.6,21.4,23
95653,527,280,247,28.6,28.2,30.3
95655,4314,2183,2131,31.9,31.5,32.3
95658,6285,3142,3143,48.7,48.3,49
95659,702,372,330,46.9,45.3,49
95660,30714,15149,15565,32,30.8,33.4
95661,29791,14092,15699,40.3,38.4,41.8
95662,31558,15585,15973,40.7,39.3,42.3
95663,2377,1170,1207,46.9,46.9,46.9
95664,1380,715,665,48.3,48.6,47.8
95665,4426,2242,2184,51.2,49.9,52.7
95666,5336,2695,2641,54.4,54.2,54.7
95667,36726,17909,18817,47.7,46.4,48.6
95668,815,440,375,42,41,42.8
95669,2443,1184,1259,47.7,47.7,47.7
95670,52973,25694,27279,35.8,34.3,37.2
95672,4773,2413,2360,45.3,44.3,46.2
95673,15455,7781,7674,35.9,34.4,37.3
95674,935,479,456,42.5,41.3,43.6
95675,381,174,207,45.8,46.7,43.8
95677,23333,11364,11969,39.2,37.4,40.7
95678,41192,20063,21129,33.8,32.7,34.8
95679,55,28,27,47.1,47.3,44.8
95680,146,77,69,33.7,29.8,35.8
95681,1226,617,609,40.4,39,41.4
95682,29114,14249,14865,43.1,42,44
95683,6180,3047,3133,49.4,48.3,50.5
95684,3422,1743,1679,50.8,50.3,51.2
95685,4680,2236,2444,51.2,50.1,52.3
95686,1405,699,706,32.7,32.2,33.2
95687,65096,35533,29563,37.9,37.7,38.1
95688,34379,16980,17399,37.9,36.8,39
95689,1244,617,627,58.3,58.8,58.1
95690,2533,1353,1180,39,38.4,40
95691,34737,17068,17669,33.8,33.2,34.4
95692,4769,2324,2445,35.5,34.6,36.4
95693,6758,3371,3387,45.1,44.9,45.2
95694,9156,4650,4506,37.7,36.7,38.8
95695,37946,18579,19367,37.1,35,39
95697,425,202,223,36.5,39.4,33.1
95698,236,120,116,45.5,47,43
95699,154,81,73,50.3,48.3,53.5
95701,983,524,459,49.6,48.6,50.2
95703,897,473,424,48,48.2,47.9
95709,4772,2394,2378,48,47.7,48.3
95713,9495,4778,4717,46,45.3,46.8
95714,382,209,173,52.6,54.5,50.6
95715,115,65,50,47.4,47.8,46
95717,231,120,111,53.6,53.3,54.1
95720,157,77,80,53.4,52.4,54.5
95721,37,22,15,53.5,52.5,55.5
95722,4585,2304,2281,49.5,49.1,49.8
95724,27,22,5,28.1,28,29.5
95726,8842,4473,4369,46.5,46.2,46.9
95728,386,231,155,47,45.9,48.9
95735,68,40,28,52.5,53,52
95736,240,129,111,29.7,27.4,33.3
95742,7749,3903,3846,31.3,31.4,31.2
95746,21460,10625,10835,45.4,45.2,45.5
95747,51870,24765,27105,37.8,36.6,38.7
95757,40222,20292,19930,32.2,31,33.2
95758,60435,28882,31553,34.4,32.4,35.8
95762,38797,19120,19677,40.4,40.1,40.6
95765,33974,16403,17571,35.3,33.8,36.3
95776,21902,10995,10907,30.4,29.4,31.3
95811,7595,4265,3330,35.1,37.5,32
95814,9922,6209,3713,36.8,36.2,38.2
95815,24680,12454,12226,31.1,31.2,31
95816,15579,7617,7962,35,35.4,34.4
95817,13534,6326,7208,33.4,32.8,34
95818,19811,9274,10537,39.9,39.4,40.4
95819,17141,7978,9163,39.5,38.6,40.2
95820,34480,16751,17729,33,32.1,34
95821,33550,15986,17564,39.7,38,41.3
95822,42347,20298,22049,37.1,35,39.1
95823,73985,35609,38376,29.1,27.9,30.2
95824,30221,15263,14958,29.1,28.3,30
95825,31084,14675,16409,32.5,31.4,33.9
95826,36628,17816,18812,33.5,31.9,35
95827,20269,10031,10238,34.6,32.9,36.6
95828,57862,28518,29344,32,30.3,33.8
95829,24755,12174,12581,33.8,32.2,35
95830,934,491,443,41.9,41,42.9
95831,41321,19420,21901,44.6,42.3,46.4
95832,11924,5763,6161,25,23.8,26.2
95833,37293,18190,19103,31,30.3,31.8
95834,25899,12538,13361,29.1,28.7,29.5
95835,35936,17389,18547,32.6,32.1,33.1
95837,315,160,155,51.1,51.2,51.1
95838,36764,18185,18579,28.4,27.9,29
95841,19448,9347,10101,33.1,31.9,34.4
95842,31806,15457,16349,30.8,29.8,31.8
95843,45048,21869,23179,31.4,30.3,32.4
95864,22447,10613,11834,45.7,44.1,47
95901,31314,15660,15654,32.3,31.4,33.3
95903,1732,988,744,21.8,21.7,22.4
95910,86,48,38,51.3,52,51
95912,4685,2413,2272,31.8,30.6,32.8
95914,578,290,288,48.9,49,48.8
95915,44,26,18,52.8,53.5,52.5
95916,1441,767,674,54.1,53.3,54.5
95917,3155,1576,1579,37.2,35.9,38.4
95918,2339,1191,1148,47.9,48.4,47.5
95919,1378,692,686,50.3,47.5,52
95920,274,155,119,34.8,33.9,39.5
95922,687,372,315,50.3,50,50.6
95923,58,37,21,47,46.5,47.5
95925,295,154,141,41.3,41.7,39.8
95926,37725,18823,18902,27.2,26.4,28.4
95928,36511,18308,18203,29.4,28.2,30.8
95930,69,37,32,50.5,50.5,51.5
95932,7718,3879,3839,35.4,34.7,36
95934,274,138,136,52,48.5,54.3
95935,631,344,287,48.4,48,48.8
95936,352,186,166,57.2,57.6,56.6
95937,1491,713,778,43,43.1,42.6
95938,3787,1891,1896,42.3,41.3,43
95939,604,356,248,40.7,39,45.7
95941,563,293,270,54.3,54.4,54.3
95942,1301,657,644,50.6,51.7,49.7
95943,879,463,416,37.3,37.2,37.7
95944,46,27,19,57,53.8,57.4
95945,25199,11806,13393,47.1,43.8,49.6
95946,9790,4772,5018,52.7,51.7,53.5
95947,1899,943,956,48.3,47.3,49.4
95948,10810,5361,5449,35.2,33.9,36.6
95949,19741,9774,9967,50.7,49.7,51.7
95950,569,296,273,33.6,33.8,33.4
95951,2601,1330,1271,29.1,29.5,28.6
95953,10718,5159,5559,33.9,33.4,34.4
95954,12251,6094,6157,49.2,48.2,50.1
95955,1517,796,721,36.6,34.1,38.4
95956,401,206,195,52.5,53.1,52.3
95957,761,398,363,44.8,45,44.6
95959,17838,9051,8787,50.5,49.8,51.2
95960,796,422,374,48,46,50
95961,26510,13356,13154,29.5,29.2,29.7
95962,1567,799,768,49.9,50.4,49.5
95963,15493,7740,7753,36.2,35.3,37
95965,20384,10303,10081,34.8,33.5,36.2
95966,30643,15085,15558,43.5,41.7,44.9
95968,1412,719,693,35.9,36.2,35.8
95969,27549,13122,14427,50.4,48.5,52.2
95970,530,277,253,45.2,46.7,42.8
95971,5970,2949,3021,45.5,44.5,46.5
95973,31957,15688,16269,36.8,35.4,38.3
95974,8,4,4,25,25.5,24
95975,1769,890,879,50.1,49.3,50.7
95977,1678,839,839,42.4,42.6,42.3
95978,143,72,71,34.5,31,40.5
95979,597,329,268,52,49.8,52.9
95981,97,48,49,50.8,53,42.5
95982,3221,1654,1567,40.1,38.7,41.1
95983,428,217,211,52.7,52.9,52.6
95984,120,60,60,57.3,58.7,55.5
95986,162,96,66,52,50.5,53
95987,5992,3130,2862,29.8,28.8,31
95988,8857,4443,4414,35.5,34.6,36.7
95991,40593,20052,20541,31.7,30.6,33
95993,36067,17959,18108,37.4,35.8,38.6
96001,33865,16735,17130,42,40.4,43.8
96002,33298,16228,17070,37.5,35.1,39.7
96003,44461,21557,22904,40.7,38.7,42.5
96006,557,272,285,48.2,47.6,48.9
96007,22841,11196,11645,40.6,38.7,42.5
96008,1231,622,609,45.5,45.6,45.4
96009,569,295,274,44.6,44.6,44.7
96010,239,133,106,50.3,50.3,50.3
96011,218,118,100,47.8,49.3,44.8
96013,4212,2064,2148,44,42.6,45.5
96014,211,112,99,52.4,52.3,52.5
96015,465,223,242,41.6,43.5,40
96016,366,191,175,58.8,58.1,60.2
96017,171,102,69,51.3,52.5,50.5
96019,10082,5029,5053,38.6,37,40.3
96020,2416,1223,1193,47.8,46.9,48.7
96021,16097,8012,8085,35.2,34,36.5
96022,15768,7830,7938,42.2,41.2,43.1
96023,1240,636,604,42.8,40.5,45.1
96024,1145,591,554,50.2,51.4,48.2
96025,2310,1188,1122,47.7,46,49.9
96027,2227,1144,1083,50.1,48.8,51.5
96028,1464,744,720,48.5,48.1,48.7
96029,124,61,63,51.3,53.3,49.2
96031,158,92,66,54,55.5,52.3
96032,2407,1250,1157,45.7,44.1,48
96033,432,224,208,50.6,50.6,50.7
96034,294,156,138,51.8,50,52.8
96035,3324,1701,1623,37.3,35.1,39.4
96037,308,152,156,52.6,53.3,51.5
96038,589,301,288,46.9,43.9,49.3
96039,1251,642,609,47.6,47.4,48.2
96040,341,171,170,49.8,48.5,51.5
96041,2747,1430,1317,48.1,49.2,47.1
96044,1022,515,507,52.4,52.1,52.8
96046,304,173,131,52.3,52.9,51.3
96047,1004,511,493,48.9,49.3,48.3
96048,736,374,362,53,53,53
96049,95,50,45,52.4,55.5,50.5
96050,414,214,200,55.6,56.8,54
96051,1139,594,545,56.5,56.4,56.7
96052,1460,796,664,51.1,49.4,53
96054,366,181,185,48.4,50.5,47.3
96055,3935,1942,1993,44.9,44.8,45
96056,1642,845,797,50.2,49.9,50.5
96057,1355,681,674,53.6,53,54.5
96058,798,431,367,41.5,40.9,43.3
96059,688,352,336,53.9,55.2,53.6
96061,36,20,16,63,62.5,64.5
96062,1105,535,570,46.3,46.1,46.8
96063,125,64,61,50.8,53,48.5
96064,4574,2288,2286,47.1,46.4,47.6
96065,357,196,161,49.8,46.5,52.4
96067,7165,3420,3745,50,49.2,50.9
96068,183,142,41,37.3,33,47.5
96069,982,512,470,49.7,49.6,49.7
96071,125,63,62,62.5,63.3,61.8
96073,4082,2035,2047,49.6,49.7,49.6
96074,260,181,79,41,37.5,54.4
96075,369,226,143,46.1,43,51.4
96076,166,88,78,55.3,55.7,54.5
96080,28764,14102,14662,39.5,37.7,41.1
96084,625,315,310,51.5,52.9,50
96085,85,44,41,45.3,46.5,43.8
96086,338,168,170,51.8,52.4,50.5
96087,600,296,304,50.1,50,50.1
96088,4506,2306,2200,54.1,54,54.2
96090,421,212,209,44.1,43.3,44.8
96091,699,363,336,56.5,56.6,56.3
96092,496,269,227,40.9,41.3,40.2
96093,4133,2025,2108,45,43.5,46.5
96094,6630,3376,3254,43.8,41.8,46
96096,695,350,345,52,52.3,51.5
96097,10031,4826,5205,44.8,42.7,46.5
96101,5490,2777,2713,44.7,43,46.2
96103,1725,848,877,58.8,58.9,58.6
96104,748,368,380,49.9,49.5,50.6
96105,527,285,242,45.9,45.8,46
96106,479,238,241,62,62.4,61.5
96107,1269,628,641,36.4,34.5,38.7
96108,122,64,58,57.5,51.5,59.5
96109,2197,1664,533,37,35.8,46.7
96110,166,87,79,55,54.8,55.3
96111,160,83,77,51.6,52.3,51.2
96112,214,98,116,40.6,43,40.2
96113,1000,497,503,38.9,39.1,38.8
96114,3220,1639,1581,43.4,44,42.8
96115,145,72,73,59.3,59.4,58.9
96116,233,129,104,45.1,42.5,45.7
96117,405,199,206,45.1,44.3,45.3
96118,1627,807,820,46.6,45,47.6
96119,90,52,38,54,52.5,54
96120,957,481,476,46.9,47.4,46.2
96121,368,200,168,51.1,51,51.5
96122,3883,1918,1965,45,44.3,45.8
96123,48,25,23,44.5,41.8,46.5
96124,326,157,169,50.6,51.8,48.9
96125,258,134,124,56.4,55.5,57.3
96126,215,115,100,52.3,51.6,53
96128,752,410,342,39.1,36.5,42.3
96129,261,146,115,43.8,42.5,45.5
96130,23150,15788,7362,35.1,34,39
96132,119,61,58,56.3,55.3,57.5
96133,110,55,55,45,40.5,46.5
96134,2512,1283,1229,35.2,36.3,34.1
96135,128,68,60,46,45,47.3
96136,104,56,48,45.3,46.5,43
96137,3297,1681,1616,50.5,50.3,50.7
96140,1170,633,537,46.2,46.4,45.9
96141,744,401,343,48.7,48.1,49.5
96142,1037,574,463,43.3,43.5,43.2
96143,4414,2433,1981,32.6,32.4,33
96145,3161,1689,1472,43.3,41.9,45
96146,1366,802,564,39.7,38.4,42.2
96148,788,425,363,38.5,37.4,39.7
96150,29792,15802,13990,38,37.1,39.1
96155,8,5,3,46,42.5,60.5
96161,18451,9669,8782,38.4,38.1,38.7
97635,165,89,76,57.9,60.7,55